5
25
000000000000000000000000
000000000000000000000000
001110020010000011002000
111110111110001111111111
111110111110001111111111